
{
    "NumberMap": 
    [
        {
        "name" : 00, 
        "textureFilepath" : "Media/Images/Ground_Tiles/0.png", 
        "Width" : 16,
        "Heigth" : 16,
        "Scale" : {"x" : 2, "y" : 2},
        "Collision" : false,
        "RandomEncounter" : {}
        },

        {
        "name" : 01, 
        "textureFilepath" : "Media/Images/Ground_Tiles/1.png", 
        "Width" : 16,
        "Heigth" : 16,
        "Scale" : {"x" : 2, "y" : 2},
        "Collision" : false,
        "RandomEncounter" : {}
        },

        {
        "name" : 03, 
        "textureFilepath" : "Media/Images/Ground_Tiles/3.png", 
        "Width" : 16,
        "Heigth" : 16,
        "Scale" : {"x" : 2, "y" : 2},
        "Collision" : false,
        "RandomEncounter" : {}
        },

        {
        "name" : 04, 
        "textureFilepath" : "Media/Images/Ground_Tiles/4.png", 
        "Width" : 16,
        "Heigth" : 16,
        "Scale" : {"x" : 2, "y" : 2},
        "Collision" : false,
        "RandomEncounter" : {}
        },

        {
        "name" : 05, 
        "textureFilepath" : "Media/Images/Ground_Tiles/5.png", 
        "Width" : 16,
        "Heigth" : 16,
        "Scale" : {"x" : 2, "y" : 2},
        "Collision" : false,
        "RandomEncounter" : {}
        },

        {
        "name" : 06, 
        "textureFilepath" : "Media/Images/Ground_Tiles/6.png", 
        "Width" : 16,
        "Heigth" : 16,
        "Scale" : {"x" : 2, "y" : 2},
        "Collision" : false,
        "RandomEncounter" : {}
        },

        {
        "name" : 07, 
        "textureFilepath" : "Media/Images/Ground_Tiles/7.png", 
        "Width" : 16,
        "Heigth" : 16,
        "Scale" : {"x" : 2, "y" : 2},
        "Collision" : false,
        "RandomEncounter" : {}
        },

        {
        "name" : 08, 
        "textureFilepath" : "Media/Images/Ground_Tiles/8.png", 
        "Width" : 16,
        "Heigth" : 16,
        "Scale" : {"x" : 2, "y" : 2},
        "Collision" : false,
        "RandomEncounter" : {}
        },

        {
        "name" : 09, 
        "textureFilepath" : "Media/Images/Ground_Tiles/9.png", 
        "Width" : 16,
        "Heigth" : 16,
        "Scale" : {"x" : 2, "y" : 2},
        "Collision" : false,
        "RandomEncounter" : {}
        },

        {
        "name" : 10, 
        "textureFilepath" : "Media/Images/Ground_Tiles/10.png", 
        "Width" : 16,
        "Heigth" : 16,
        "Scale" : {"x" : 2, "y" : 2},
        "Collision" : false,
        "RandomEncounter" : {}
        },

        {
        "name" : 11, 
        "textureFilepath" : "Media/Images/Ground_Tiles/11.png", 
        "Width" : 16,
        "Heigth" : 16,
        "Scale" : {"x" : 2, "y" : 2},
        "Collision" : false,
        "RandomEncounter" : {}
        },

        {
        "name" : 12, 
        "textureFilepath" : "Media/Images/Ground_Tiles/12.png", 
        "Width" : 16,
        "Heigth" : 16,
        "Scale" : {"x" : 2, "y" : 2},
        "Collision" : false,
        "RandomEncounter" : {}
        },

        {
        "name" : 13, 
        "textureFilepath" : "Media/Images/Ground_Tiles/13.png", 
        "Width" : 16,
        "Heigth" : 16,
        "Scale" : {"x" : 2, "y" : 2},
        "Collision" : false,
        "RandomEncounter" : {}
        },

        {
        "name" : 14, 
        "textureFilepath" : "Media/Images/Ground_Tiles/14.png", 
        "Width" : 16,
        "Heigth" : 16,
        "Scale" : {"x" : 2, "y" : 2},
        "Collision" : false,
        "RandomEncounter" : {}
        },

        {
        "name" : 15, 
        "textureFilepath" : "Media/Images/Ground_Tiles/15.png", 
        "Width" : 16,
        "Heigth" : 16,
        "Scale" : {"x" : 2, "y" : 2},
        "Collision" : false,
        "RandomEncounter" : {}
        },

        {
        "name" : 16, 
        "textureFilepath" : "Media/Images/Ground_Tiles/grass.png", 
        "Width" : 16,
        "Heigth" : 16,
        "Scale" : {"x" : 2, "y" : 2},
        "Collision" : false,
        "RandomEncounter" : {"EncounterChance" : 15, "MinLevel" : 10, "MaxLevel" : 20}
        }
    ],

    "Map" :
    [
    [14,14,14,14,14,14,14,14,14,14,14,14,14,14,14,14,14,14,14,14,14,14,14,14,14,14,14,14,14,14,14,14,14,14,14,14,14,14,14,14,14,14,14,14,14,14,14,14,14,14,15,14,14,14,14,14,14,14,14,14,14],
    [14,14,14,14,14,14,14,14,14,14,14,14,14,14,14,14,14,14,14,14,14,14,14,14,14,14,14,14,14,14,14,14,14,14,14,14,14,14,14,14,14,14,15,14,14,14,14,15,14,14,15,15,14,14,14,14,14,14,14,14,14],
    [14,14,14,14,14,14,14,14,14,14,14,14,14,14,14,14,14,14,14,14,14,14,14,14,14,14,14,14,14,14,14,14,14,14,14,14,14,14,14,14,14,14,15,14,14,14,14,15,14,14,14,15,14,14,14,14,14,14,14,14,14],
    [14,14,14,14,14,14,14,14,14,14,14,14,14,14,14,14,14,14,14,14,14,14,14,14,14,14,14,14,14,14,14,14,14,14,14,14,14,14,14,14,14,14,14,15,14,14,14,15,15,14,14,15,14,14,15,14,15,14,14,14,15],
    [14,14,14,14,14,14,14,14,14,14,14,14,14,14,14,14,14,14,14,14,14,14,14,14,14,14,14,14,14,14,14,14,14,14,14,14,14,14,14,14,14,14,14,14,14,14,14,14,14,14,15,14,14,14,14,14,14,14,14,14,14],
    [14,14,14,14,14,14,14,14,14,14,14,14,14,14,14,14,14,14,14,14,14,14,14,14,14,14,14,14,14,14,14,14,14,14,14,14,14,14,14,14,14,14,15,14,14,14,14,15,14,14,15,15,14,14,14,14,14,14,14,14,14],
    [14,14,14,14,14,14,14,14,14,14,14,14,14,14,14,14,14,14,14,14,14,14,14,14,14,14,14,14,14,14,14,14,14,14,14,14,14,14,14,14,14,14,15,14,14,14,14,15,14,14,14,15,14,14,14,14,14,14,14,14,14],
    [14,14,14,14,14,14,14,14,14,14,14,14,14,14,14,14,14,14,14,14,14,14,14,14,14,14,14,14,14,14,14,14,14,14,14,14,14,14,14,14,14,14,14,15,14,14,14,15,15,14,14,15,14,14,15,14,15,14,14,14,15],
    [14,14,14,14,14,14,14,14,14,14,14,14,14,14,14,14,14,14,14,14,14,14,14,14,14,14,14,14,14,14,14,14,14,14,14,14,14,14,14,14,14,14,14,14,14,14,14,15,14,14,14,15,14,14,15,14,15,14,14,14,15],
    [14,14,14,14,14,14,14,14,14,14,14,14,14,14,14,14,14,14,14,14,14,14,14,14,14,14,14,14,14,14,14,14,14,14,14,14,14,14,14,14,14,14,15,14,14,07,03,03,03,03,03,08,14,14,14,14,14,14,14,14,14],
    [14,14,14,14,14,14,14,14,14,14,14,14,14,14,14,14,14,14,14,14,14,14,14,14,14,14,14,14,14,14,14,14,14,14,14,14,14,14,14,14,14,14,15,14,14,00,13,13,13,13,13,01,14,14,16,16,16,16,16,14,14],
    [14,14,14,14,14,14,14,14,14,14,14,14,14,14,14,14,14,14,14,14,14,14,14,14,14,14,14,14,14,14,14,14,14,14,14,14,14,14,14,14,14,14,15,14,14,00,13,13,13,13,13,01,14,14,16,16,16,16,16,14,14],
    [14,14,14,14,14,14,14,14,14,14,14,14,14,14,14,14,07,03,03,03,03,03,03,08,14,14,14,14,14,14,14,14,14,14,14,14,14,14,14,14,14,14,15,14,14,00,13,13,13,13,13,01,14,14,16,16,16,16,16,14,14],
    [14,14,14,07,03,03,03,03,03,03,03,03,03,03,03,03,12,13,13,13,13,13,13,11,03,03,03,03,03,03,03,03,03,03,03,03,03,03,03,03,03,03,03,03,03,12,13,13,13,13,13,01,14,14,16,16,16,16,16,14,14],
    [14,14,14,00,13,13,13,13,13,13,13,13,13,13,13,13,13,13,13,13,13,13,13,13,13,13,13,13,13,13,13,13,13,13,13,13,13,13,13,13,13,13,13,13,13,13,13,13,13,13,13,01,14,14,16,16,16,16,16,14,14],
    [14,14,14,00,13,13,13,13,13,13,13,13,13,13,13,13,13,13,13,13,13,13,13,13,13,13,13,13,13,13,13,13,13,13,13,13,13,13,13,13,13,13,13,13,13,13,13,13,13,13,13,01,14,14,16,16,16,16,16,14,14],
    [14,14,14,00,13,13,13,13,13,13,13,13,13,13,13,13,13,13,13,13,13,13,13,13,13,13,13,13,13,13,13,13,13,13,13,13,13,13,13,13,13,13,13,13,13,13,13,13,13,13,13,01,14,14,16,16,16,16,16,14,14],
    [14,14,14,00,13,13,13,13,13,13,13,13,13,13,13,13,13,13,13,13,13,13,13,13,13,13,13,13,13,13,13,13,13,13,13,13,13,13,13,13,13,13,13,13,13,13,13,13,13,13,13,01,14,14,16,16,16,16,16,14,14],
    [14,14,14,00,13,13,13,13,13,13,13,13,13,13,13,13,13,13,13,13,13,13,13,13,13,13,13,13,13,13,13,13,13,13,13,13,13,13,13,13,13,13,13,13,13,13,13,13,13,13,13,01,14,14,16,16,16,16,16,14,14],
    [14,14,14,05,04,04,04,04,04,04,04,04,04,04,04,04,04,04,04,04,04,04,04,04,04,04,10,13,13,13,13,13,13,13,13,13,13,13,13,13,13,13,13,13,13,13,13,13,13,13,13,01,14,14,16,16,16,16,16,14,15],
    [14,14,14,14,14,14,14,14,14,14,14,14,14,14,14,14,14,14,14,14,14,14,14,14,14,14,00,13,13,13,13,13,13,13,13,13,13,13,13,13,13,13,13,13,13,13,13,13,13,13,13,01,14,14,16,16,16,16,16,14,14],
    [14,14,14,14,14,14,14,14,14,14,14,14,14,14,14,14,14,14,14,14,14,14,14,14,14,14,00,13,13,13,13,13,13,13,13,13,13,13,13,13,13,13,13,13,13,13,13,13,13,13,13,01,14,14,16,16,16,16,16,14,15],
    [14,14,14,14,14,14,14,14,14,14,14,14,14,14,14,14,14,14,14,14,14,14,14,14,14,14,00,13,13,13,13,13,13,13,13,13,13,13,13,13,13,13,13,13,13,13,13,13,13,13,13,01,14,14,16,16,16,16,16,14,15],
    [14,14,14,14,14,14,14,14,14,14,14,14,14,14,14,14,14,14,14,14,14,14,14,14,14,14,00,13,13,13,13,13,13,13,13,13,13,13,13,13,13,13,13,13,13,13,13,13,13,13,13,01,14,14,16,16,16,16,16,14,15],
    [14,14,14,14,14,14,14,14,14,14,14,14,14,14,14,14,14,14,14,14,14,14,14,14,14,14,00,13,13,13,13,13,13,13,13,13,13,13,13,13,13,13,13,13,13,13,13,13,13,13,13,01,14,14,16,16,16,16,16,14,15],
    [14,14,14,14,14,14,14,14,14,14,14,14,14,14,14,14,14,14,14,14,14,14,14,14,14,14,00,13,13,13,13,13,13,13,13,13,13,13,13,13,13,13,13,13,13,13,13,13,13,13,13,01,14,14,16,16,16,16,16,14,15],
    [14,14,14,14,14,14,14,14,14,14,14,14,14,14,14,14,14,14,14,14,14,14,14,14,14,14,00,13,13,13,13,13,13,13,13,13,13,13,13,13,13,13,13,13,13,13,13,13,13,13,13,01,14,14,16,16,16,16,16,14,15],
    [14,14,14,14,14,14,14,14,14,14,14,14,14,14,14,14,14,14,14,14,14,14,14,14,14,14,00,13,13,13,13,13,13,13,13,13,13,13,13,13,13,13,13,13,13,13,13,13,13,13,13,01,14,14,16,16,16,16,16,14,15],
    [14,14,14,14,14,14,14,14,14,14,14,14,14,14,14,14,14,14,14,14,14,14,14,14,14,14,00,13,13,13,13,13,13,13,13,13,13,13,13,13,13,13,13,13,13,13,13,13,13,13,13,01,14,14,16,16,16,16,16,14,15],
    [14,14,14,14,14,14,14,14,14,14,14,14,14,14,14,14,14,14,14,14,14,14,14,14,14,14,00,13,13,13,13,13,13,13,13,13,13,13,13,13,13,13,13,13,13,13,13,13,13,13,13,01,14,14,16,16,16,16,16,14,15],
    [14,14,14,14,14,14,14,14,14,14,14,14,14,14,14,14,14,14,14,14,14,14,14,14,14,14,00,13,13,13,13,13,13,13,13,13,13,13,13,13,13,13,13,13,13,13,13,13,13,13,13,01,14,14,16,16,16,16,16,14,15],
    [14,14,14,14,14,14,14,14,14,14,14,14,14,14,14,14,14,14,14,14,14,14,14,14,14,14,00,13,13,13,13,13,13,13,13,13,13,13,13,13,13,13,13,13,13,13,13,13,13,13,13,01,14,14,16,16,16,16,16,14,15],
    [14,14,14,14,14,14,14,14,14,14,14,14,14,14,14,14,14,14,14,14,14,14,14,14,14,14,00,13,13,13,13,13,13,13,13,13,13,13,13,13,13,13,13,13,13,13,13,13,13,13,13,01,14,14,16,16,16,16,16,14,15],
    [14,14,14,14,14,14,14,14,14,14,14,14,14,14,14,14,14,14,14,14,14,14,14,14,14,14,00,13,13,13,13,13,13,13,13,13,13,13,13,13,13,13,13,13,13,13,13,13,13,13,13,01,14,14,15,14,15,14,14,14,15],
    [14,14,14,14,14,14,14,14,14,14,14,14,14,14,14,14,14,14,14,14,14,14,14,14,14,14,00,13,13,13,13,13,13,13,13,13,13,13,13,13,13,13,13,13,13,13,13,13,13,13,13,01,14,14,15,14,15,14,14,14,15],
    [14,14,14,14,14,14,14,14,14,14,14,14,14,14,14,14,14,14,14,14,14,14,14,14,14,14,00,13,13,13,13,13,13,13,13,13,13,13,13,13,13,13,13,13,13,13,13,13,13,13,13,01,14,14,15,14,15,14,14,14,15],
    [14,14,14,14,14,14,14,14,14,14,14,14,14,14,14,14,14,14,14,14,14,14,14,14,14,14,00,13,13,13,13,13,13,13,13,13,13,13,13,13,13,13,13,13,13,13,13,13,13,13,13,11,03,03,03,03,03,08,15,15,15],
    [14,14,14,14,14,14,14,14,14,14,14,14,14,14,14,14,14,14,14,14,14,14,14,14,14,14,00,13,13,13,13,13,13,13,13,13,13,13,13,13,13,13,13,13,13,13,13,13,13,13,13,13,13,13,13,13,13,01,15,14,14]

    ],

    "Architecture" :
    [
        {
        "textureFilepath" : "Media/Images/Houses/greenHouse2.png",
        "Position" : { "x" : 770, "y" : 80},
        "Scale" : {"x" : 1.5, "y" : 1.5},
        "Collision" : true
        },
        {
        "textureFilepath" : "Media/Images/Houses/blueHouse2.png",
        "Position" : { "x" : 310, "y" : 130},
        "Scale" : {"x" : 1.5, "y" : 1.5},
        "Collision" : true
        },
        {
        "textureFilepath" : "Media/Images/fountain.png",
        "Position" : { "x" : 600, "y" : 400},
        "Scale" : {"x" : 1, "y" : 1},
        "Collision" : true
        }

    ]
}